Argentina: argentinian
Bolivia: bolivian
Brazil: brazilian
Chile: chilean
Colombia: colombian
Ecuador: ecuadorian
Guyana: guyanese
Paraguay: paraguayan
Peru: peruvian
Suriname: surinamese
Uruguay: uruguayan
Venezuela: venezuelan
Antigua and Barbuda: antiguan%20and%20barbudan
Bahamas: bahamian
Barbados: barbadian
Belize: belizean
Canada: canadian
Costa Rica: costa%20rican
Cuba: cuban
Dominica: dominican
Dominican Republic: dominican
El Salvador: salvadoran
Grenada: grenadian
Guatemala: guatemalan
Haiti: haitian
Honduras: honduran
Jamaica: jamaican
Mexico: mexican
Nicaragua: nicaraguan
Panama: panamanian
Saint Kitts and Nevis: kittitian%20and%20nevisian
Saint Lucia: saint%20lucian
Saint Vincent and the Grenadines: saint%20vincentian
Trinidad and Tobago: trinidadian%20and%20tobagonian
USA: american
Albania: albanian
Andorra: andorran
Armenia: armenian
Austria: austrian
Azerbaijan: azerbaijani
Belarus: belarusian
Belgium: belgian
Bosnia and Herzegovina: bosnian%20and%20herzegovinian
Bulgaria: bulgarian
Croatia: croatian
Cyprus: cypriot
Czech Republic: czech
Denmark: danish
Estonia: estonian
Finland: finnish
France: french
Georgia: georgian
Germany: german
Greece: greek
Hungary: hungarian
Iceland: icelandic
Ireland: irish
Italy: italian
Kosovo: kosovar
Latvia: latvian
Liechtenstein: liechtensteiner
Lithuania: lithuanian
Luxembourg: luxembourgish
Malta: maltese
Moldova: moldovan
Monaco: monegasque
Montenegro: montenegrin
Netherlands: dutch
North Macedonia: macedonian
Norway: norwegian
Poland: polish
Portugal: portuguese
Romania: romanian
Russia: russian
San Marino: sanmarinese
Serbia: serbian
Slovakia: slovak
Slovenia: slovenian
Spain: spanish
Sweden: swedish
Switzerland: swiss
Turkey: turkish
Ukraine: ukrainian
United Kingdom: british
Vatican City: vatican
Algeria: algerian
Angola: angolan
Benin: beninese
Botswana: botswanan
Burkina Faso: burkinabe
Burundi: burundian
Cabo Verde: cape%20verdean
Cameroon: cameroonian
Central African Republic: central%20african
Chad: chadian
Comoros: comorian
Congo: congolese
Democratic Republic of the Congo: congolese
Djibouti: djiboutian
Egypt: egyptian
Equatorial Guinea: equatoguinean
Eritrea: eritrean
Eswatini: swazi
Ethiopia: ethiopian
Gabon: gabonese
Gambia: gambian
Ghana: ghanaian
Guinea: guinean
Guinea-Bissau: bissau-guinean
Ivory Coast: ivorian
Kenya: kenyan
Lesotho: basotho
Liberia: liberian
Libya: libyan
Madagascar: malagasy
Malawi: malawian
Mali: malian
Mauritania: mauritanian
Mauritius: mauritian
Morocco: moroccan
Mozambique: mozambican
Namibia: namibian
Niger: nigerien
Nigeria: nigerian
Rwanda: rwandan
Sao Tome and Principe: sao%20tomean
Senegal: senegalese
Seychelles: seychellois
Sierra Leone: sierra%20leonean
Somalia: somali
South Africa: south%20african
South Sudan: south%20sudanese
Sudan: sudanese
Tanzania: tanzanian
Togo: togolese
Tunisia: tunisian
Uganda: ugandan
Zambia: zambian
Zimbabwe: zimbabwean
Afghanistan: afghan
Armenia: armenian
Azerbaijan: azerbaijani
Bahrain: bahraini
Bangladesh: bangladeshi
Bhutan: bhutanese
Brunei: bruneian
Cambodia: cambodian
China: chinese
Cyprus: cypriot
Georgia: georgian
India: indian
Indonesia: indonesian
Iran: iranian
Iraq: iraqi
Israel: israeli
Japan: japanese
Jordan: jordanian
Kazakhstan: kazakh
Kuwait: kuwaiti
Kyrgyzstan: kyrgyz
Laos: laotian
Lebanon: lebanese
Malaysia: malaysian
Maldives: maldivian
Mongolia: mongolian
Myanmar: burmese
Nepal: nepalese
North Korea: north%20korean
Oman: omani
Pakistan: pakistani
Palestine: palestinian
Philippines: filipino
Qatar: qatari
Saudi Arabia: saudi
Singapore: singaporean
South Korea: south%20korean
Sri Lanka: sri%20lankan
Syria: syrian
Taiwan: taiwanese
Tajikistan: tajik
Thailand: thai
Timor-Leste: timorese
Turkey: turkish
Turkmenistan: turkmen
United Arab Emirates: emirati
Uzbekistan: uzbek
Vietnam: vietnamese
Yemen: yemeni
Australia: australian
Fiji: fijian
Kiribati: i-kiribati
Marshall Islands: marshallese
Micronesia: micronesian
Nauru: nauruan
New Zealand: new%20zealander
Palau: palauan
Papua New Guinea: papua%20new%20guinean
Samoa: samoan
Solomon Islands: solomon%20islander
Tonga: tongan
Tuvalu: tuvaluan
Vanuatu: ni-vanuatu